10 10
0 1 2 3 4 5 1 2 3 4 
0 0 0 0 0 0 0 0 0 0 
0 5 0 0 0 0 0 0 0 5 
0 0 5 0 0 0 0 0 5 0 
0 0 0 5 0 0 0 5 0 0 
0 0 0 0 5 0 5 0 0 0 
0 0 0 0 0 5 0 0 0 0 
0 0 0 0 0 0 0 0 0 0 
0 0 0 0 0 0 0 0 0 0 
0 0 0 0 0 0 0 0 0 0 
